1111111111
1316710451
1640110111
1167010301
1401611601
1031617061
1110401601
1060170011
1137141621
1111111111